111111111111111
1C00000001000E1
100001000000111
100011000100001
10P0000001000C1
1100010C0100001
111111111111111