111111111111111
1C00000001000E1
10P001000000111
100011000100001
1000000001000C1
1000010C0100001
111111111111111