111111111111111
1000000001000E1
10P001000100111
100011000100001
100000000100001
100001000100001
111111111111111