1111111111111111111111111
11011E001100C111100011001
10P0111001001110000110C01
11001100000001000C0000001
1100000001000001000011001
1110010C0110001100011C011
1111111111111111111111111