1111111111111111111111111
1000000001000111000010001
1000010001001110000100E01
1000110001000100000000001
1000000000000001000011001
1P00010001000011000011011
1111111111111111111111111