1111111111111111111111111
110110C01100C111100011001
10P0111001001110000110E01
11001100000001000C0000001
110C000001000001000011001
100001000110001100111C011
111001100111C001111011111
1111000000100011100000111
111110000000100000011C011
1111111111111111111111111